111111111111111
1P10C010C010C01
101010101010101
101010101010101
101010101010101
101010101010101
101010101010101
101010101010101
101010101010101
101010101010101
10C010C010C01E1
111111111111111
