111111111111111111111
1P011111111100000C011
1001111C011C011111001
100111100111111111001
1C0111100111000000011
10000C0000C0011111111
1111111C011C011111111
1111111001100000000E1
111111111111111111111